This is a not-even-alpha version of a game about cables and music. If you encounter frustration or confusion, this is not (yet) intended; please let me know.
If you're playing this in an interpreter (not in-browser), please type "transcript on" to create a recording of your session to be used for debugging any problems. Otherwise, please copy-paste the session into an e-mail. In either case, please send to abesto0@gmail.com, along with any feedback.
If you get stuck, you can type "hint" to get a hint. The first one is free: you can type "hint" multiple times for increasingly spoilery hints.

A note on talking to the game: due to limitations of the engine, some phrasings will work better for plugging things in than others. For best results, plug cables into objects (like "plug HDMI cable into monitor"), or into specific sockets (like "plug jack cable into headphone out"). For objects with hard-wired cables, try plugging in the object itself (like "plug right speaker into left speaker").

The not quite stereo
A story of the Chaos of Cables by Zoltan Nagy
Release 2 / Serial number 160824 / Inform 7 build 6M62 (I6/v6.33 lib 6/12N) SD

Your Room
Getting a proper speaker setup has been on your bucket list for a while now. This is not a purchase one makes lightly - it should provide you with quality entertainment for years to come. After researching your options and getting opinions from co-workers, you've now finally hauled the big box of sound home. You've just finished unpacking the speakers: the left and right satellite speakers are looking at you anxiously from the corners of the desk, and the subwoofer is firmly on the ground, already plugged into the power strip. You have the manual. You have the cables. It's time to get wiring.

Your trusty MacBook sits patiently on the desk, with Spotify open, playing your weekly Discover playlist.

On the white desk are the left speaker, the right speaker, a Dell monitor, and a manual.

On the floor are a box of cables (in which are a gray HDMI cable and a jack cable) and a subwoofer.

>examine story
You can't see any such thing.

* * *

>hint
This is an interactive fiction game. You control your avatar by typing commands like "look", "look at laptop", "examine hdmi cable", and "plug jack cable into bottom RCA socket" (not something that will work, this last one). Your goal is wire up all the equipment in the room to get a working sound system.

>hint
Remember how you have a manual? How about reading it? Maybe it'll give you some hints.

>hint
I'm out of hints; the next time you ask for help, I'll just give you the solution. Seriously. So be careful what you ask for!

>hint
Alright, here goes.
plug left speaker into bottom RCA socket
plug right speaker into subwoofer
plug HDMI cable into laptop
plug HDMI cable into monitor
plug jack cable into monitor
plug jack cable into subwoofer

* * *

>hint
This is an interactive fiction game. You control your avatar by typing commands like "look", "look at laptop", "examine hdmi cable", and "plug jack cable into bottom RCA socket" (not something that will work, this last one). Your goal is wire up all the equipment in the room to get a working sound system.

>plug jack cable into bottom RCA socket
The jack cable has no free plugs that match bottom RCA socket.

Music is playing from the built-in speakers of your MacBook. You can't hear most of the bass line.

>recording on
That's not a verb I recognize.

>record
That's not a verb I recognize.

>record on
That's not a verb I recognize.

>transcript on
Start of a transcript of

The not quite stereo
An Interactive Fiction by Zoltan Nagy
Release 1 / Serial number 160823 / Inform 7 build 6M62 (I6/v6.33 lib 6/12N) SD
Identification number: //338274A2-F92E-4404-8BB6-7F9F730D292D//
Interpreter version 0.5.2 / VM 3.1.2 / Library serial number 080126
Standard Rules version 3/120430 by Graham Nelson
Plugs and Sockets version 4/150909 by Sean Turner

>look
Your Room
It's the same room you've been living in for the last year or so. Right now, you're focused on a tiny corner of it: the part with a white table and a stereo system to set up.

Your trusty MacBook sits patiently on the desk, with Spotify open, playing your weekly Discover playlist.

Next to it is a relatively small Dell monitor.

On the floor are a box of cables (in which are a gray HDMI cable and a jack cable) and a subwoofer.

Music is playing from the built-in speakers of your MacBook. You can't hear most of the bass line.

>transcript off
End of transcript.

>plug jack plug into laptop
You can't use multiple objects with that verb.

>plug jack cable into laptop
That doesn't sound right. Maybe you should read the manual.

Music is playing from the built-in speakers of your MacBook. You can't hear most of the bass line.

* * *

>l
Your Room
It's the same room you've been living in for the last year or so. Right now, you're focused on a tiny corner of it: the part with a white table and a stereo system to set up.

Your trusty MacBook sits patiently on the desk, with Spotify open, playing your weekly Discover playlist.

Next to it is a relatively small Dell monitor.

On the floor are a box of cables (in which are a gray HDMI cable and a jack cable) and a subwoofer.

Music is playing from the built-in speakers of your MacBook. You can't hear most of the bass line.

>l table
The previous tenants left this here; it's been holding up all your computery stuff ever since.

On the white desk are a MacBook and a Dell monitor.

Music is playing from the built-in speakers of your MacBook. You can't hear most of the bass line.

* * *

>l spotify
Way more convinient than having to buy and switch CDs all the time, or maintaining a music collection manually. It even tells you what music to like based on data, magic, and maybe some guesswork. There may be a moral in here about how machine learning is making humans lazier, but who has time to think about that when you have cables to connect. It's playing your Discover Weekly playlist. Black Stone Cherry, Godsmack, Nine Lashes, Rise Against - the good stuff.

Music is playing from the built-in speakers of your MacBook. You can't hear most of the bass line.

>look at spotify
I only understood the first part of that-- trying anyway.

Retrying as:
>LOOK
Your Room
It's the same room you've been living in for the last year or so. Right now, you're focused on a tiny corner of it: the part with a white table and a stereo system to set up.

Your trusty MacBook sits patiently on the desk, with Spotify open, playing your weekly Discover playlist.

On the white desk are the left speaker, the right speaker, and a Dell monitor.

On the floor are a box of cables (in which are a gray HDMI cable and a jack cable) and a subwoofer.

Music is playing from the built-in speakers of your MacBook. You can't hear most of the bass line.

* * *

>l spotify
Way more convinient than having to buy and switch CDs all the time, or maintaining a music collection manually. It even tells you what music to like based on data, magic, and maybe some guesswork. There may be a moral in here about how machine learning is making humans lazier, but who has time to think about that when you have cables to connect. It's playing your Discover Weekly playlist. Black Stone Cherry, Godsmack, Nine Lashes, Rise Against - the good stuff.

Music is playing from the built-in speakers of your MacBook. You can't hear most of the bass line.

>plug jack cable into jack socket
You plug the jack cable into green jack socket.

Music is playing from the built-in speakers of your MacBook. You can't hear most of the bass line.

>unplug jack plug
There are none at all available!

>unplug jack cable
(from the subwoofer)
You unplug the jack cable from the subwoofer.

Music is playing from the built-in speakers of your MacBook. You can't hear most of the bass line.

>plug jack plug into jack socket
You can't use multiple objects with that verb.

>look at the rca socket
Which do you mean, 1) white RCA socket, 2) red RCA socket, or 3) bottom RCA socket?

>3
It is a female RCA connector of the subwoofer. It has nothing plugged into it.

Music is playing from the built-in speakers of your MacBook. You can't hear most of the bass line.

>3
It is a female RCA connector of the subwoofer. It has nothing plugged into it.

Music is playing from the built-in speakers of your MacBook. You can't hear most of the bass line.

>plug
(the manual into the manual)
The manual has no plug.

Music is playing from the built-in speakers of your MacBook. You can't hear most of the bass line.

>plug rca plug
(into the manual)
The manual has no socket.

Music is playing from the built-in speakers of your MacBook. You can't hear most of the bass line.

* * *

>l white rca socket
It's labelled "AUX".

Music is playing from the built-in speakers of your MacBook. You can't hear most of the bass line.

* * *

>look at desk
The previous tenants left this here; it's been holding up all your computery stuff ever since.

On the white desk is a MacBook.

Music is playing from the built-in speakers of your MacBook. You can't hear most of the bass line.

* * *

>look at scenery
I only understood the first part of that-- trying anyway.

Retrying as:
>LOOK

Type UNDO if this isn't what you wanted to do, or CORRECT OFF to stop automatically correcting commands.

To stop these messages entirely, type NOVICE OFF.

Your Room
It's the same room you've been living in for the last year or so. Right now, you're focused on a tiny corner of it: the part with a white table and a stereo system to set up.

Your trusty MacBook sits patiently on the desk, with Spotify open, playing your weekly Discover playlist.

On the white desk are the left speaker, the right speaker, and a Dell monitor.

On the floor are a box of cables (in which are a gray HDMI cable and a jack cable) and a subwoofer.

Music is playing from the built-in speakers of your MacBook. You can't hear most of the bass line.

* * *

>plug
What do you want to plug?

>rca plug
What do you want to plug the RCA plug into?

>bottom rca plug
You typed a rather long command and I didn't understand it. It's better to stick to simpler things like TAKE JACK PLUG.

To stop these messages entirely, type NOVICE OFF.

>plug rca plug into bottom rca plug
You typed a rather long command and I didn't understand it. It's better to stick to simpler things like TAKE JACK PLUG.

>novice off
Novice mode disabled.

>plug rca plug into bottom rca plug
I only understood you as far as wanting to plug the RCA plug into bottom RCA socket.

>plug rca plug into bottom rca socket
You plug the RCA plug into bottom RCA socket.

Music is playing from the built-in speakers of your MacBook. You can't hear most of the bass line.

>look at green jack socket
It is a female jack connector of the subwoofer. It has nothing plugged into it.

Music is playing from the built-in speakers of your MacBook. You can't hear most of the bass line.

* * *

>plug jack plug
You can't use multiple objects with that verb.

>looka t jack plug
That's not a verb I recognize.

>look at jack plug
You can't use multiple objects with that verb.

>jack plug
That's not a verb I recognize.

>look at jack plug
You can't use multiple objects with that verb.

>look at jack plugs
You can't use multiple objects with that verb.

>showme jack plug
jack plug - jack plug
location: part of the jack cable in the box of cables on the floor in Your Room
singular-named, improper-named, ordinarily enumerated; unlit, inedible, portable, neuter
list grouping key: none
printed name: "jack plug"
printed plural name: "jack plugs"
indefinite article: none
description: none
initial appearance: none
PS-type: "jack"
gender: PS-male
jack plug - jack plug
location: part of the jack cable in the box of cables on the floor in Your Room
singular-named, improper-named, ordinarily enumerated; unlit, inedible, portable, neuter
list grouping key: none
printed name: "jack plug"
printed plural name: "jack plugs"
indefinite article: none
description: none
initial appearance: none
PS-type: "jack"
gender: PS-male

>plug the jack cable into the socket
Which do you mean, the HDMI socket, white RCA socket, red RCA socket, green jack socket, the HD15 socket, or bottom RCA socket?

* * *

>plug jack plug into headphone out
You can't use multiple objects with that verb.

>rules
Rules tracing now switched on. Type "rules off" to switch it off again, or "rules all" to include even rules which do not apply.

>tracing 5
That's not a verb I recognize.

>trace 5
[Rule "declare everything initially unmentioned rule" applies.]
[Parser tracing set to level 5.]

* * *

>trace off
[ "trace" trace / "off" off ]
[Parsing for the verb 'trace' (4 lines)]

[line 0 * -> TraceOn]
 [line 0 token 1 word 2 : END]

[line 1 * number -> TraceLevel]
 [line 1 token 1 word 2 : number]
  [token resulted in failure with error type 3]

[line 2 * 'on' -> TraceOn]
[line rejected for not ending with correct preposition]

[line 3 * 'off' -> TraceOff]
 [line 3 token 1 word 2 : 'off']
  [token resulted in success]
 [line 3 token 2 word 3 : END]
[Line successfully parsed]
[Rule "declare everything initially unmentioned rule" applies.]
Trace off.

>actions off
[Rule "declare everything initially unmentioned rule" applies.]
Actions listing off.

>plug the jack cable into the jack socket
You can't use multiple objects with that verb.

>plug the jack cable into the macbook
(the MacBook)
[Rule "declare everything initially unmentioned rule" applies.]
[Rule "announce items from multiple object lists rule" applies.]
[Rule "set pronouns from items from multiple object lists rule" applies.]
[Rule "before stage rule" applies.]
[Rule "instead stage rule" applies.]
[Rule "investigate player's awareness before action rule" applies.]
[Rule "player aware of his own actions rule" applies.]
[Rule "check stage rule" applies.]
[Rule "don't-plug-jack-into-laptop rule" applies.]
That doesn't sound right. Maybe you should read the manual.

[Rule "A first turn sequence rule" applies.]
[Rule "every turn stage rule" applies.]
[Rule "Every turn" applies.]
[Rule "Every turn" applies.]
Music is playing from the built-in speakers of your MacBook. You can't hear most of the bass line.

[Rule "A last turn sequence rule" applies.]
[Rule "notify score changes rule" applies.]

* * *

>plug jack plug into socket
You can't use multiple objects with that verb.

>plug jack plug into jack socket
You can't use multiple objects with that verb.

>plug the jack cable into the socket
Which do you mean, the HDMI socket, white RCA socket, red RCA socket, green jack socket, the HD15 socket, or bottom RCA socket?

>jack socket
You plug the jack cable into green jack socket.

Music is playing from the built-in speakers of your MacBook. You can't hear most of the bass line.

>look at display
You always mean to get a bigger one, but one step at a time - for now, let's set up the stereo. The display has a "No Input" message moving around on it. On the back of the screen there's an HDMI input, and a small jack (output) socket. They're kind of hard to reach, but by now you can plug cables into them by touch.

The Dell monitor has nothing plugged into it.

Music is playing from the built-in speakers of your MacBook. You can't hear most of the bass line.

>look at jack
You can't use multiple objects with that verb.

>look at jack plug
You can't use multiple objects with that verb.

>look at jack cable
You see nothing special about the jack cable.

It is plugged into a subwoofer.

Music is playing from the built-in speakers of your MacBook. You can't hear most of the bass line.

>plug right speaker into left speaker
The left speaker has no socket.

Music is playing from the built-in speakers of your MacBook. You can't hear most of the bass line.

* * *

>plug left speaker into bottom RCA socket
You plug the left speaker into bottom RCA socket.

Music is playing from the built-in speakers of your MacBook. You can't hear most of the bass line.

>plug right speaker into subwoofer
You plug the right speaker into the subwoofer.

Music is playing from the built-in speakers of your MacBook. You can't hear most of the bass line.

>plug HDMI cable into laptop
You don't hear any music at all.

>plug HDMI cable into monitor
The screen of your laptop goes black. After a few seconds the display comes back to life, along with the external Dell monitor, which is now mirroring the display of the MacBook.

You don't hear any music at all.

>plug jack cable into monitor
You plug the jack cable into the Dell monitor.

You don't hear any music at all.

I beg your pardon?

* * *

>plug jack cable into monitor
You plug the jack cable into the Dell monitor.

You don't hear any music at all.

>plug jack cable into subwoofe
You can't see any such thing.

>plug jack cable into subwoofer
You plug the jack cable into the subwoofer.

    *** It's done.
You've connected all the wires, the system is alive. Clean, strong bass is pumping out the subwoofer, and the speakers on the desk give you the best listening of Korn you've had in a while. You sit back, close your eyes...

Then you turn your head to the left a bit, then to the right... Something's not right. It's like the stereo is not stereo after all. Only one speaker is blasting Korn, the other is just sitting there quietly. How can this be? It's a brand new system! It's time to do some debugging.

This concludes the tutorial. The rest of the game, to be implemented, will center on you trying to get the right speaker to work. Please don't forget to send send the transcript of your game, along with any feedback, to abesto0@gmail.com. Thanks for testing! ***

Would you like to RESTART, RESTORE a saved game, QUIT, or UNDO the last command?

* * *

>plug jack cable into monitor
You plug the jack cable into the Dell monitor.

You don't hear any music at all.

>plug jack cable into subwoofer
You plug the jack cable into the subwoofer.

It's done.
You've connected all the wires, the system is alive. Clean, strong bass is pumping out the subwoofer, and the speakers on the desk give you the best listening of Korn you've had in a while. You sit back, close your eyes...

Then you turn your head to the left a bit, then to the right... Something's not right. It's like the stereo is not stereo after all. Only one speaker is blasting Korn, the other is just sitting there quietly. How can this be? It's a brand new system! It's time to do some debugging.

    *** This concludes the tutorial. The rest of the game, to be implemented, will center on you trying to get the right speaker to work. Please don't forget to send send the transcript of your game, along with any feedback, to abesto0@gmail.com. Thanks for testing! ***

Would you like to RESTART, RESTORE a saved game, QUIT, or UNDO the last command?

* * *

>read manual
A five-page pamphlet with lots of tiny letters. The only part that looks interesting is about how to wire up the stereo. There's a section detailing a desktop setup - surprisingly helpful.

1. Plug the RCA cable coming out the back of the left satellite speaker into the bottom RCA socket on the subwoofer, labelled "left speaker".
2. Connect the HD15 cable coming out the back of the right satellite speaker to the subwoofer.
3. Connect your laptop or desktop computer to your display via HDMI.
4. Plug one end the provided jack-jack audio cable into the stereo output of your display.
5. Plug the other end of the jack-jack audio cable into the jack socket on the subwoofer.

Music is playing from the built-in speakers of your MacBook. You can't hear most of the bass line.

>look at bottom rca socket
A female RCA connector on the subwoofer. The plastic rim of the socket is black. The words "Left speaker" are printed next to it.

Music is playing from the built-in speakers of your MacBook. You can't hear most of the bass line.